########........*#########################
####.....#############.............#######
####.#############################.####@##
####.......####....................#######
#########.......##################...#####
###########.#############......#####.#####
#######.....################.#####..^#####
#######.....#############...............##
#.................................########
##########################################