####################################################
#^...........###########......#########*.........###
##########..##############.#####################.###
#################..........#####################.###
##########################.......................###
####################################################