#########*..######.###....###
##.....###.####.....#####...#
###.####...##...###..###...##
##..##...###..###^.......####
##.#####.##........###.######
##...........#########..#####
#######.###############.#####
####....................#####