##############################################
#.............#######........##############.##
#..........#######......#######.............##
#...^................##############..######..#
#...........#####....#####...........#########
#.........##########.............###.#########
########.........................###.........#
##*....#####################################.#
######.######................................#
####.....####.################################
####............##############################
##############################################