#################
#..^..####...####
###...####...####
###..........####
#################