#################
#........##..#..#
#.###.##.###...##
#..##.#...##.#..#
##.####.#....#.##
##^.....####*#..#
#################